1111111111111111111
1CCCCCCCC1CCCCC1111
1C11C111C1C111C1111
1CCCCCCCCCCCCCCCCC1
1C11CCCC1111C1C11C1
1CCCC111C1CCC1CCCC1
1111C111C1C111C1111
1001C111CCCCC1C1001
1111CCCCC011C1C1111
1000CCCC1CCCCCC0001
1111C1C111C1C1C1111
1001E1CC1CCCC1C1001
1111C1CC1CCCC1C1111
1CCCCCCCCCCCCCCCCC1
1C11C111P1C111C11C1
1CC1CCCCCCCCCCC1CC1
11C1C1C11111C1C1C11
1CCCC1CCC1CCC1CCCC1
1C111111C1C111111C1
1CCCCCCCC1CCCCCCCC1
1111111111111111111