1111111111111111111
1CCCCCCCC1CCCCCCC11
1CC1CC1CC1C111C11C1
1C111CCCCCCCCCCCCC1
1CC1CCC11111C1C11C1
1CCCC1CCC1CCC1CCCC1
1111C111C1C111C1111
1001C1CCCCCCC1C1001
1111C1C11011C1C1111
1000CCCCGGGCCCC0001
1111C1C11111C1C1111
1001E1CCCCCCC1C1001
1111C1C11111C1C1111
1CCCCCCCC1CCCCCCCC1
1C11C111P1C111C11C1
1CC1CCCCCCCCCCC1CC1
11C1C1C11111C1C1C11
1CCCC1CCC1CCC1CCCC1
1C111111C1C111111C1
1CCCCCCCC1CCCCCCCC1
1111111111111111111

