1111111111111111111111111
1P01000000001000000000001
1000011111011000000000001
1001110000010000000000001
1001000000011001000000001
10010000EC001000000000001
1001000000001000000000001
1001000000001000111000001
1001000000001000000000001
1000000000001000000000001
1001000000001000000000001
1001000000001000000000001
1001000000001000000000001
1001000000000000000110001
1001000000000000000110001
1000000000000000000000001
1111111111111111111111111