1111111111111111111
1CCCCCCCC1CCCCCCCC1
1C11C111C1C111C11C1
1CCCCCCCCCCCCCCCCC1
1C11CCC11111C1C11C1
1CCCC1CCC1CCC1CCCC1
1111C111C1C111C1111
1001C1CCCCCCC1C1001
1111C1C11011C1C1111
1000CCCCGGGCCCC0001
1111C1C11111C1C1111
10C1E1CCCCCCC1C1001
1111C1C11111C1C1111
1CCCCCCCC1CCCCCCCC1
1C11C111P1C111C11C1
1CC1CCCCCCCCCCC1CC1
11C1C1C11111C1C1C11
1CCCC1CCC1CCC1CCCC1
1C111111C1C111111C1
1CCCCCCCCCCCCCCCCC1
1111111111111111111