1111111111111111111111111
1P01000000001000000000001
1000011111001000000000001
10011E0000010000000000001
1001000000001001000000001
100100000C001000000000001
1001000000001000000000001
1001000000001000000000001
1001000000001000000000001
1000000000001000000000001
1001000000001000000000001
1001000000001000000000001
1001000000001000000000001
1001000000000000000000001
1001000000000000000000001
1000000000000000000000001
1111111111111111111111111